7 10
0 0 0 0 0 0 0 0 0 0 
0 2 3 0 1 1 1 0 0 0
0 0 1 0 0 0 1 0 0 0
0 0 1 1 1 0 1 0 0 0
0 0 0 0 1 0 1 0 0 0
0 0 1 1 1 1 1 0 0 0
0 0 0 0 0 0 0 0 0 0
2
0 0 550 150 0
1 0 100 100 1
1
0 0 150 150