sprites/grass.png
sprites/sandbagbeige.png
8 8
0 0 0 0 0 0 0 0 
0 2 1 0 0 0 0 0
0 0 3 0 0 0 0 0
0 0 1 0 0 0 0 0
0 0 1 0 0 0 0 0
0 0 1 0 0 0 0 0
0 0 1 1 1 1 1 0
0 0 0 0 0 0 0 0 
3
0 0 100 100 3
1 0 300 75 2
1 0 300 423 0
1
1 0 300 300 
