7 10
0 0 0 0 0 0 0 0 0 0 
0 2 3 0 1 1 1 0 0 0
0 0 1 0 0 0 1 0 0 0
0 0 1 1 1 0 1 0 0 0
0 0 0 0 1 0 1 0 0 0
0 0 1 1 1 1 1 0 0 0
0 0 0 0 0 0 0 0 0 0
5
2 2 200 500