8 8
0 0 0 0 0 0 0 0 
0 2 3 0 0 0 0 0
0 0 1 0 0 0 0 0
0 0 1 0 0 0 0 0
0 0 1 0 0 0 0 0
0 0 1 0 0 0 0 0
0 0 1 1 1 1 1 0
0 0 0 0 0 0 0 0 
3
0 0 100 100 3
1 0 300 300 2
1 0 300 423 0