sprites/sand.png
sprites/sandbagbeige.png
7 10
0 0 0 0 0 0 0 0 0 0 
0 2 1 0 1 1 1 0 0 0
0 0 3 0 0 0 1 0 0 0
0 0 1 1 1 0 1 0 0 0
0 0 0 0 1 0 1 0 0 0
0 0 1 1 1 1 1 0 0 0
0 0 0 0 0 0 0 0 0 0
2
0 0 550 150 0
1 0 100 100 1
3
1 0 750 355 
1 0 405 355 
1 0 150 355 
